equivocate	intentionally use vague language
Impervious	impossible to penetrate; incapable of being affected
Intractable	not easily managed or manipulated
fidelity	loyalty; exact correspondence
imprecation	curse; damnation
discerning	perceptive; exhibiting keen insight and good judgement
inveterate	confirmed; long standing
multifarious	diverse
malleable	capable of being shaped by pounding; impressionate
Palliate	to make less serious; ease
August	dignified; grandiose
sensual	relating to the senses, gratifying the physical (sexual) senses
Interregnum	period between reigns
insularity	narrow-mindedness; isolation
singular	unique, extraordinary, odd
log	record of a voyage; record of daily activities
expatriate	to send into exile
canard	false; deliberately misleading story
morose	ill-humored; sullen
Abeyance	temporary suppression or supension
propitiate	to win over, appease
fallacious	based on a false idea or fact; misleading
Numismatics	coin collecting
ambivalence	the state of having conflicting emotional attitudes
Ethos	beliefs or character of a group
ebullient	exhilarated; overly enthusiastic
miscreant	villain; criminal
appease	to calm, pacify, placate
Ignoble	having low moral standards; not noble in character; mean
bedizen	to dress in a vulgar, showy manner
metamorphosis	change; transformation
subside	to settle down, grow quiet
Arbitrary	determined by chance or impulse
Attenuate	to reduce in force or degree; weaken
stanch	to stop or check the flow of
Exacerbate	to make worse
ethnocentric	based on the attitude tha one's group is superior
asperity	severity; harshness; irritability
Apocryphal	of questionable authority or authenticity
Upbraid	to scold sharply
reprise	repetition, especially of a piece of music
vendetta	prolonged feud marked by bitter hostility
sobriety	seriousness
torpor	lethargy, dormancy, sluggishness
apex	the highest point
Maudlin	overly sentimental
motley	many colored; made up of many parts
Sobriquet	nickname
limn	to draw, describe
pique	fleeting feeling or hurt pride
engender	to cause; produce
precept	principle; law
sinuous	intricate, complex
Efficacy	effectiveness
inundate	to cover with water, overwhelm
Loquacious	talkative
Veracity	filled with truth and accuracy
capricous	fickle
Dissonance	a harsh and disagreeable combination, especially of sounds
gregarious	outgoing; sociable
Panoply	impressive array
Wraith	a ghost or specter; a ghost of a living person seen just before his or her death
luminous	bright; brilliant; glowing
Antipathy	extreme dislike
welter	wallow or roll, toss about, be in turmoil
Viscous	thick and adhesive, like a slow-flowing fluid
suppliant	beseeching
Obviate	to prevent; to make unnecessary
elicit	to provoke; draw out
Malinger	to evade responibilty by pretending to be ill
Approbation	approval and praise
subsume	to include, incorporate
canon	an established set of principles; a basis or standard for judgment; a group of literary works
impecunious	poor; having no money
perennial	present throughout the years; persistent
Pristine	fresh and clean; uncorrupted
Opaque	impossible to see through; preventing the passage of light
bombastic	pompous; using inflated language
minutia	petty details
facetious	homorous
Ambiguous	doubtful or uncertain; can be interpreted several ways
categorical	absolute; without exception
burnish	to polish
juggernaut	huge froce destrying everything in its path
minatory	threatening; menacing
Deface	to mar the appearance of; vandalize
Impetuous	quick to act without thinking
refractory	stubborn, resisting ordinary methods of treatment
permeable	penetrable
salubrious	healthful
Desiccate	to dry out thoroughly
substantive	essential
Burnish	to polish
geniality	cheerfulness; kindliness; sociability
levity	light manner or attitude
Dictum	authoritative statement
homily	sermon; tedious moralizing lecture
Licentious	immoral; unrestrained by society
discrepancy	difference between
query	question
Abate	to reduce in amount, degree, or severity
Rococo	very highly ornamented; relating to an 18th century artistic style of elaborate ornamentation
presumptuous	rude; improperly bold
premonition	forewarning; presentiment
doggerel	poor verse
placate	soothe; pacify
strut	to swagger, display to impress others
hieroglyphics	a system of writing in which pictorial symbols represent meanings or sounds; wirting or symbols that are difficult to decipher
Grievous	causing grief or sorrow; serious and distressing
fallow	plowed but not sowed; uncultivated
Toady	one who flatters in the hope of gaining favors
Sportive	frolicsome; playful
abeyance	temporary suppression or suspension
halcyon	calm and peaceful; happy; golden; prosperous
Lucid	clear and esily understood
obsequious	overly submissive
mitigate	alleviate; to become less severe
abstemious	moderate in appetite
Winsome	charming; happily engaging
Exponent	one who champions or advocates
churlish	rude; boorish
Wan	sickly pale
introspective	contemplating one's own thoughts and feelings
encomium	a formal expression of praise
bovine	cowlike
Neophyte	novice; beginner
raiment	clothing
concoct	to invent
anarchy	absence of government; state of disorder
behemoth	huge creature; anything very large and powerful
Vim	vitality and energy
Amortize	to diminish by installment payments
olfactory	concerning the sense of smell
Redress	relief from wrong or injury
ramification	implication, consequence
impinge	to strike; encroach
Invidious	envious, obnoxious, or offensive, likely to promote ill-will
wary	careful, cautious
fulsome	so excessive as to be disgusting
Ameliorate	to make better; to improve
Talon	claw of an animal, especially a bird of prey
sartorial	pertaining to tailors
cartography	science of making maps
Imprecation	a curse
itinerant	wandering from place to place; unsettled
coquette	woman who flirts
peremptory	imperative; leaving no choice
extemporaneous	unrehearsed
Penury	an oppressive lack of resources (as money); severe poverty
diffuse	to spread out
Kindle	to set fire to or ignite; excite or inspire
caucus	smaller group within an organization
perturb	to disturb greatly; make uneasy or anxious
Bevy	group
Salubrious	healthful
quail	to cower, lose heart
Florid	excessively decorated or embellished
lassitude	lethargy; sluggishness
paleonthology	study of past geological eras through fossil remains
Edify	to instruct morally and spiritually
Abstemious	moderate in appetite
Fecund	fertile; fruitful; productive
champion	to defend or support
Stolid	unemotional; lacking sensitivity
malinger	to feign illness to escape duty
assiduous	diligent; hard-working
stentorian	extremely loud
equable	steady; unvarying; serene
Plucky	courageous; spunky
plethora	excess; overabundance
dirge	funeral hymn
Encomium	warm praise
litany	lengthy recitation; repetitive chant
Cosset	to pamper; treat with great care
opprobium	public disgrace; contempt
commensurate	proportional
disingenuous	not candid, crafty
fresco	a painting done on plaster
embellish	to adorn; enhance
repudiate	to reject as having no authority
avocation	secondary occupation
rarefied	refined
piety	devoutness
travesty	parody, exaggerated imitation, caricature
libertine	one without moral restraint
Noisome	stinking; putrid
Aerie	a nest built high in the air; an elevated, often secluded, dwelling
guise	outward appearance; false appearance
precipitate	rash; hasty; sudden; done without deliberation
dissident	person who disagrees about beliefs
enhance	to increase; improve
connoisseur	expert in matters of taste; expert knowledge or training
Molt	to shed hair, skin, or an outer layer periodically
Rhetoric	effective writing or speaking
bifurcate	to divide into two parts
filibuster	use of obstructive tactics in a legislature to block passage of a law
sylvan	related to the woods or forest
fulminate	to attack loudly; denounce
Inimical	hostile; unfriendly
perfidious	faithless; disloyal; untrustworthy
dupe	to deceive; trick
Cabal	a secret group seeking to overturn something
dichotomy	division into two usually contradictory parts
preamble	preliminary statement
quibble	to argue over insignificant and irrelevant details
evince	to show plainly; be an indication of
anomalous	irregular; deviating from the norm
punctilious	careful in observing rules fo behavior
grandiloquent	pompous; bombastic
quorum	number of memeber necessary to conduct a meeting
Solecism	gtrammatical mistake; blunder in speech
lustrous	shining
dismiss	put away from consideration; reject
compunction	uneasiness caused by guilt
aggregate	amounting to a whole; total
Ingrate	ungrateful person
factotum	a person who does all sorts of work; a handyman
Jettison	to discard; to get rid of as unnecessary or encumbering
avuncular	like an uncle, benevolent and tolerant
abdicate	to give up a position, right, or power
machinations	plots or schemes
stipulate	to specify as an essential condition
repine	fret, complain
Anomaly	deviation from what is normal
Trenchant	acute, sharp, or incisive; forecful; effective
Calumny	a false and malicious accusation; misrepresentation
Larceny	theft of property
servile	submissive, obedient
reproach	to find fault with, blame
wistful	vaguely longing, sadly thoughtful
exigency	crisis; urgent requirements
estimable	admirable; possible to estimate
subversive	intended to undermine or underthrow, especially an established government
finesse	to handle with a deceptive or evasive strategy; refined in performance
Stigma	a mark of shame or discredit
clamor	noisy outcry
Surly	rude and bad-tempered
Monastic	extremly plain or secluded, as in a monastery
audacious	bold; daring
misogynist	one who hates women
pragmatic	practical
Lissome	easily flexed; limber; agile
Permeate	to penetrate
untenable	indefensible
Officious	too helpful; meddlesome
Banal	predictable; cliched; boring
igneous	produced by fire; volcanic
Innocuous	harmless
convoluted	twisted; complicated
mettlesome	full of courage and fortitude
dissemble	to pretend; disguise one's motives
Taciturn	silent; not talkative
Forestall	to prevent or delay; anticipate
incarnate	having bodily form
Nadir	lowest point
Iconoclast	one who opposes established beliefs, customs, and institutions
Aberrant	deviating from what is normal or expected
Oblique	indirect or evasive; misleading or devious
Investiture	ceremony conferring authority
Enigma	a puzzle; a mystery
enervate	to weaken
limpid	clear; transparent
adamant	uncompromising; unyielding
extant	in existence; not lost
Itinerant	wandering from place to place; unsettled
Cloying	sickly sweet; excessive
mollify	to soothe
treatise	article treating a subject systematically and thoroughly
occlude	to shut; block
maelstrom	whirpool; turmoil
Orotund	pompous
impede	to hinder; block
evocative	tending to call to mind or produce a reaction
amalgamate	to combine into a unified whole
Bolster	to support; prop up
reprobate	morally unprincipled person
dogmatic	stating opinions without proof
Dilettante	someone with an amateurish and superficial interest in a topic
Maelstrom	whirlpool; turmoil; agitated state of mind
etymology	origin an history of a word
Ossify	to change in to bone; to become hardened or set in a rigidly conventional pattern
raconteur	witty, skillful storyteller
Machination	plot or scheme
Eschew	to shun; to avoid (as something wrong or distasteful)
Terrestrial	earthly; down to earth; commonplace
abscission	the act of cutting; the natural separation of a leaf or other part of a plant
Capricious	changing one's mind quickly and often
exacerbate	to aggravate; make worse
Listless	lacking energy and enthusiasm
concave	curving inward
metereological	concerned with the weather
Philistine	a person who is guided by materialism and is disdainful of intellectual or artistic values
vaunt	to boast, drag
phlegmatic	unemotional; calm in temperament
sanction	to approve, ratify, permit
obdurate	stubborn
paucity	scarcity
Frenetic	frantic; frenzied
Demur	to express doubts or objections
diffidence	shyness; lack of confidence
Implacable	unable to be calmed down or made peaceful
Levity	an inappropriate lack of seriousness; overly casual
flux	flowing; a continuous moving
bucolic	characteristic of the countryside; rustic; pastoral
miscellany	mixture of writtings on various subjects
rue	regret
distill	extract the essential elements
fracas	a loud quarrel; brawl
apposite	strikingly appropriate and relevant
Mendacious	dishonest
mundane	worldy as opposed to spiritual; concerned with the ordinary
Bombastic	pompous in speech and manner
rescind	to cancel
Iniquity	sin; evil act
asylum	place of refuge or shelter
affected	pretentious; phony
Guile	deceit; trickery
Belfry	bell tower; room in which a bell in hung
Dyspeptic	suffering from indigestion; gloomy and irritable
Bonhomie	good-natured geniality; atmosphere of good cheer
Raconteur	witty, skillful storyteller
glib	fluent in an insincere way; offhand
convex	curved outward
sporadic	irregular
Garrulous	tending to talk a lot
pallid	lacking color or liveliness
Verbose	wordy
Exonerate	to clear of blame
Stratagem	trick designed to deceive an enemy
Laud	to giv praise; to glorify
overweening	presumptuous; arrogant
Pragmatic	practical, as opposed to idealistic
stricture	something that restrains, negative criticism
Erratic	wandering and unpredictable
ostentatious	showy; pretentious
unfeigned	not false, genuine
demur	to express doubt; question or oppose
apothegm	a terse, witty saying
delineate	to represent or depict
Propriety	the quality of behaving in a proper manner; obeying rules and customs
lilliputian	extremely small
Hermetic	tightly sealed
Inundate	to overwhelm; to cover with water
purport	to profess, suppose, claim
Imperturbable	not capable of being disturbed
carnal	of the flesh or body; related to physical appetities
theocracy	government by priests representing a god
Catalyst	something that brings about a change in something else
Tacit	done without using words
aggrandize	to make larger or greater
anachronism	something out of the proper time
paean	song of joy or triumph; a fervent expression of joy
tortuous	having many twists and turns, highly complex
vacuous	empty, void, lacking intelligence
Cacophony	harsh, jarring noise
gustatory	affecting the sense of taste
Abstain	to chose not to do something
Augury	prophecy; prediction of events
derivative	something derived; unoriginal
reparation	amends, compensation
reticent	nor speaking freely, reserved, reluctant
gauche	coarse and uncouth; clumsy
insipid	lacking in flavor; dull
inadvertenly	carelessly; unintentionally
disabuse	free from a misconception
assuage	to make less severe
Unconscionable	unscrupulous; shockingly unfair or unjust
Canard	a lie
tacit	silently understood, implied
Insurrection	rebellion
satiate	to satisfy
Sardonic	cynical; scornfully mocking
venerate	to adore, honor, respect
Keen	having a sharp edge; intellectually sharp; perceptive
Decorum	appropriateness of behavior or conduct; propriety
foment	to incite; arouse
neophyte	novice; beginner
Tyro	beginner; novice
felicitous	suitable expressed; wee-chose; appropiate
inconsequencial	insgnificant; unimportant
aberrant	deviating from what is normal
Caustic	biting in wit
linguistic	pertaining to language
Exprugate	to censor
puissant	powerful
Furtive	secret; stealthy
clairvoyant	one who can predict the future; psychic
Syncopation	temporary irregularity in musical rhythm
ameliorate	to improve
Pejorative	having bad connotations; disparaging
liberal	tolerant; broad-minded
Imbue	to infuse, dye, wet, or moisten
squalor	filthy, wretched condition
profound	deep, not superficial
antecedent	something that comes before
obviate	to make unnecessary; to anticipate and prevent
idolatry	idol worship; blind or excessive devotion
conscript	a person compulsorily enrolled for military service
chivalry	the qualities idealized by knighthood such as bravery and gallantry toward women
calumny	false and malicious accusation; slander
blase	bored because of frequent indulgence; unconcerned
Fervid	intensely emotional; feverish
Placate	to soothe or pacify
translucent	partially transparent
travail	work, especially arduous work
mettle	courage; endurance
artifact	item made by human craft
solvent	able to meet financial obligations
burgeon	to grow and flourish
Abyss	an extreely deep hole
abysmal	very bad
Inquest	an investigatin; an inquiry
prevaricate	to quibble; evade the truth
cantankerous	irritable; ill-humored
Turgid	swollen as from a fluid; bloated
captious	faultfinding; intended to entrap, as in an argument
Overwrought	agitated; overdone
Onerous	troublesome and oppresive; burdensome
accrue	to accumulate; grow by additions
elegy	poem or song expressing lamentation
insouciant	indifferent; lacking concern or care
recluse	person who lives in seclusion and often in solitude
zealot	one who is fanatically devoted to a cause
Paradox	a contradiction or dilemma
refulgent	brightly shining, resplendent
Phalanx	a compact or close-knit body of people, animals, or things
rail	to scold with bitter or abusive language
Meticulous	extremely careful; fastidious; painstaking
doctrinaire	dogmatic; unyielding
Scintilla	trace amount
solicitous	concerned, attentive, eager
cozen	to mislead by trick or fraud; decieve
Sublime	lofty or grand
spectrum	band of color, broad range of related ideas or objects
stupefy	to dull the senses of, stun, atonish
Sanguine	ruddy; cheerfully optimistic
covetous	desiring something owned by another
junta	group of people united in political intrigue
Husband	to manage economically; to use sparingly
Soporific	causing sleep or lethargy
disjointed	lacking order or coherence; dislocated
feral	existing in a wild or untamed state
incorporate	introduce something into another thing already in existence
discrete	constituing a separate thing; distinct
Alleviate	to make more bearable
Candid	impartial and honest in speech
tractable	obedient, yielding
reverent	expressing deep respect, worshipful
confound	to baffle; perplex; mix up
dross	waste; worthless matter
Lapidary	relating to precious stones or the art of cutting them
Mendicant	beggar
Mores	fixed customs or manners; moral attitudes
autonomous	self-governing; independent
gerrymander	to divide an area into voting districts in a way that favors a political party
occult	relating to practices connected with supernatural phenomena
Lassitude	a state of diminished energy
irascible	easily angered
onerous	burdensome
lucid	bright; clear; intelligible
impassive	showing no emotion
microcosm	a small system having analogies to a larger system
amenity	something that increases comfort
Advocate	to speak in favor of
dissolution	disintegration;debauchery
interdict	to forbid; prohibit
Bilk	to cheat; defraud
mesmerize	to hypnotize
primordial	original; existing from the beginning
presage	to foretell; indicate in advance
facilitate	to make less difficult
existential	having to do with existence
Dirge	a funeral hymn or mournful speech
implode	collapse inward violently
negate	to cancel out; nullify
perigee	point in an orbit that is closest to the earth
Opine	to express an opinion
striated	marked with thin, narrow grooves or channels
Livid	discolored from a bruise; pale; reddened with anger
gossamer	sheer; light and delicate; like cobwebs
Articulate	able to speak clearly and expressively
Inculcate	to teach; impress in the mind
deterrent	something that discourages or hinders
exculpate	to clear of blame; vindicate
intimate	marked by close acquaintance
stygian	dark and gloomy, hellish
inert	unable to move; sluggish
Lethargic	acting in an indifferent or slow, sluggish manner
ineluctable	not to be avoided or escaped; inevitable
Euphemism	use of an inoffensive word or phrase in place of a more distasteful one
nostrum	medicine or remedy of doubtful effectiveness
extrinsic	not inherent of essential
cornucopia	horn overflowing with fruit and grain; state of abundance
variegated	varied, marked with different colors
Lachrymose	tearful
Desultory	jumping from one thing to another; disconnected
Bifurcate	to divide into two parts
Mannered	artifical or stilted in character
eulogy	high praise to a death person
pungent	penetrating, caustic, to the point
endemic	inherent; belonging to an area
penchant	inclination
pathological	departing from normal condition
Acidulous	sour in taste or manner
Amalgamate	to combine; to mix together
desuetude	state of disuse
bawdy	obscene
formidable	menacing; threatening
inveigle	to win over by flattering or coaxing
Pungent	sharp and irritating to the senses
founder	to sink; fail; colapse
iconoclastic	attacking cherished traditions
Latent	potential that is not readily apparent
itinerary	route of a traveler's journey
Ephemeral	lasting a short time
Sagacious	shrewd; wise
Jargon	nonsensical talk; specialized language
contiguous	touching; neighboring; connecting without a break
Adulterate	to make impure
regale	to entertain
intransigence	stubbornness; refusal to compromise
Distend	to swell, inflate, or bloat
precursor	forerunner; predecessor
Metaphor	figure of speech comparing two different things
Tirade	long, harsh speech or verbal attack
Fortuitous	happening by chance; fortunate
Decorous	proper; tasteful; socially correct
equanimity	composure; calmness
forbearance	patience
Boor	crude person, one lacking manners or taste
flout	to treat scornfully
Juncture	point of time, especially where two things are joined
apathy	indifference
condone	to overlook voluntarily; forgive
Kinetic	relating to motion; characterized by movement
Sedition	behavior that promotes rebellion or civil disorder against the state
Enervate	to reduce in strength
chicanery	trickery; fraud
preempt	to supersede; appropiate for oneself
Repose	rexlation; leisure
Plastic	able to be molded, altered, or bent
abstinence	the giving up of certain pleasures
fractious	quarrelsome; unruly; rebellious
ruse	trick, crafty stratagem
fusion	union; synthesis
Elegy	a sorrowful poem or speech
jaundiced	havind a yellowish discoloration of the skin; affected by envy
pusillanimous	cowerdly
Judicious	sensible; showing good judgement
resolve	determination, firmness of purpose
Glib	fluent in an insincere manner; offhand; casual
emulate	to imitate; copy
analogous	comparable
skeptic	one who doubts
Kudos	fame, glory, or honor
jibe	to be in agreement
rebu	puzzle in whic pictures or symbols represent words
gambol	to frolic; leap playfully
errant	mistaken; straying from the proper course
sage	wise
euphemism	use of agreeable or inoffensive language in place of offensive language
alchemy	medieval chemical philosophy based on changing metal into gold; a seemingly magical power or process of transmutation
accretion	growth in size or increase in amount
bard	poet
futile	ineffective; useless; fruitless
Crescendo	steadily increasing in volume or force
Slake	to calm down or moderate
Magnate	powerful or influential person
Inexorable	inflexible; unyielding
Impugn	to call into question; to attack verbally
conjugal	pertaining to marriage agreement
Malleable	capable of being shaped
Neologism	new word or expression
partisan	one-sided; committed to a party, group or cause
incongruity	state of not fitting
platitude	stale; overused expression
Discern	to perceive or recognize
lascivious	lustful
proscribe	to condemn, forbid, outlaw
frieze	ornamental band on a wall
Luminous	btight; brilliant; glowing
simile	"comparison of one thing with another using ""like"" or ""as"""
Analgesia	a lessening of pain without loss of consciousness
Proclivity	a natural inclination or predisposition
affinity	fondness; liking; similarity
Vituperate	to abuse verbally; berate
Effigy	stuffed doll; likeness of a person
succor	relief, help in time of distress or want
rationale	fundamental reason
Nascent	starting to develop; coming into existence
Satiate	to satisfy fully or overindulge
demographic	related to population balance
banter	playful conversation
Restive	impatient, uneasy, or restless
Fatuous	stupid; foolishly self-satisfied
hyperbole	purposeful exaggeration for effect
stultify	to impair or reduce to uselessness
warranted	justified
Mirth	frivolity; gaiety; laughter
Incarnadine	blood-red in color
Reticent	silent; reserved
physiognomy	facial features
spendthrift	person who spends money recklessly
compliant	yielding
Martinet	strict discipliarian; one who rigidly follows rules
craven	cowardly
Diaphanous	allowing light to show through; delicate
Unequivocal	absolute; certain
Probity	complete honesty and integrity
Panegyric	elaborate praise; formal hymn of praise
supplant	to replace, substitute
Cartography	science or art of making maps
seismic	relating to earthquakes
callous	thick-skinned; insensitive
provident	providing for future need, frugal
aspersion	slander; false rumor
fervor	warmth and intensity of emotion
abjure	to reject; abandon formally
Diffident	lacking self-confidence
suffrage	the right to vote
qualified	limited, restricted
eugenics	study of factors that influence the hereditary qualities of the human race and ways to improve those qualities
transgression	act of trespassing or violating a law or rule
austere	stern; unadorned; simple
adulterate	to corrupt or make impure
discretion	quality of showing self-restraint in speech or actions
insinuate	to suggest; say indirectly; imply
Puerile	childish, immature, or silly
invidious	likely to provoke ill will
neologism	new word or expression
Contrite	deeply sorrowful and repentatnt for a wrong
laconic	using few words
Replete	abundantly supplied, complete
Anodyne	something that calms or soothes pain
conciliatory	overcoming distrust or hostility
Meretricious	gaudy; falsely attractive
Vernal	related to spring; fresh
tautology	unnecessary repetition
discredit	to dishonor; disgrace
Apostate	one who renounces a religious faith
inchoate	imperfectely formed or formulated
proliferate	to increase rapidly
discomfit	to make uneasy; disconcert
Specious	deceptively attractive; seemingly plausible but fallacious
mendicant	beggar
loquacious	talkative
effrontery	shameless boldness; presumptuousness
Waver	to fluctuate between choices
staccato	marked by abrupt, clear-cut sounds
Nuance	a subltle expression of meaning or quality
Repudiate	to reject the validity of
Sinecure	a well-paying job or office that requires little or no work
soliloquy	literary or dramatic speech by one character, not adressed to others
Libertine	a free thinker, usually used disparagingly; one without moral restraint
Gradation	process occurring by regular degrees or stages; variation in color
Peripatetic	wandering from place to place, especially on foot
plummet	to fall; plunge
contrite	very sorrowful for a wrong; seeking forgiveness
exorcise	to expel evil spirits; free from bad influences
Nominal	existing in name only; negligble
Paragon	model of excellence or perfection
admonish	to caution or reprimand
Disparate	fundamentally different; entirely unlike
Exigent	urgent; requiring immediate action
labile	likely to change
homeostasis	automatic maintenance by an organism in balance with itself
stint	to be sparing
pristine	untouched; uncorrupted
Wanton	undisciplined; unrestrained; reckless
Acme	highest point; summit; the highest level or degree attainable
usury	a practice of lending money at exorbitant rates
untoward	not favorable, troublesome, unruly
implausible	unlikely; unbelievable
Politic	shrewd and practical in managing or dealing with things; diplomatic
Perfunctory	done in a routine way; indifferent
credence	acceptance of something as true
diaphanous	transparent; vague; insubstancial
Dogmatic	dictatorial in one's opinions
libido	sexual desire
divest	to strip; deprive; rid
Dilatory	intended to delay
Multifarious	diverse
Condone	to overlook, pardon, or disregard
verbose	wordy
imbroglio	complicated situation; an entanglement
savor	to enjoy, have a distinctive flavor or smell
sedulous	diligent, assiduous
sextant	navigation tool that determines latitude and longitude
Convoluted	intricate and complicated
convivial	sociable
Transitory	temporary; lasting a brief time
egotistical	excessively self-centered; conceited
debauchery	corruption
Yoke	to join together
quagmire	marsh, difficult situation
veracious	truthful, accurate
amulet	ornament worn as a charm against evil spirits
Emulate	to copy; to try to equal or excel
Analogous	similar or alike insome way; equivalent to
rococo	excessively ornate
Archaic	ancient; old-fashioned
expiate	to atone for
plutocracy	society ruled by the wealthy
astringent	harsh; severe
ephemeral	short-lived; fleeting
hallowed	holy; sacred
Opprobrium	public disgrace
disparage	to belittle
desiccate	to dry completely
caste	any of the hereditary social classes in Hindu society; social stratification
froward	stubbornly contrary; obstinately disobedient
cacaphonous	unpleasant or harsh-sounding
Blithe	joyful; cheerful; or without appropriate thought
monolithic	solid and uniform; constituing a single, unified whole
satyr	a creature that is half-man, half beast, with the horns and legs of a goat
Equivocate	to use expressions of double meaning in order to mislead
sentient	aware, concious, able to preceive
Abscond	to leave secretly
Eclectic	selecting from or made up from a variety of soures
salutary	expecting an improvement, favorable to health
indeterminate	uncertain; indefinite
Torpor	extreme mental and physical sluggishness
Stentorian	extremely loud
Exculpate	to clear from blame; prove innocent
coalesce	to cause to become one
Invective	abusive language
Philanthropy	charity; a desire or effort to promote goodness
Embellish	to add ornamental or fictitious details
Palatial	relating to a palace; magnificent
Burgeon	to grow and flourish
Fawn	to grovel
Ribald	humorous in a vulgar way
antipathy	dislike; hostility
pedantic	showing off learning
Prevaricate	to lie or deviate from the truth
Demagogue	a leader or rabble-rouser, usually appealing to emotion or prejudice
supine	lying in the back, marked by lethargy
goad	to prod; urge on
complaisant	overly polite; willingness to comply with the wishes of others
meretricious	gaudy; specious; flasely attractive
vacillate	to waver, oscillate
aesthetic	relating to beauty or the arts
decorum	proper behavior
beatify	to sanctify; to bless; to ascribe a virtue to
Dither	to act confusedly or without clear purpose
Arrogate	to claim without justification; to claim for oneself without right
argot	a specialized vocabulary used by a group
penury	extreme poverty
circuitous	roundabout
fetid	having a bad smell
prohibitive	so high as to prevent the purchase or use of, forbidding
ardor	great emotion or passion
allay	to lessen; ease; soothe
Lavish	extremely generous or extravagant; giving unsparingly
turbid	muddy, opaque, in a state of great confusion
document	to provide with written evidence to support
Coffer	strongbox; large chest for money
Vicissitude	a change or variation; ups and downs
Perspicacious	shrewd, astute, or keen-witted
indolent	habitually lazy; idle
Gregarious	outgoing; sociable
Mercurial	quick, shrewd, and unpredictable
Plebeian	crude or coarse; characteristic of commoners
consecrate	to declare sacred
Debutante	young woman making debut in high society
Querulous	inclined to complain; irritable
Divine	to foretell or know by inspiration
meticulous	very careful; picky; fastidious
Coterie	an intimate group of persons with a similar purpose
apprise	to inform
Quiescent	motionless
litigation	legal proceedings
laud	praise
heterodox	not widely accepted
Laconic	using few words
alacrity	cheerful willingness; eagerness; speed
Stasis	a state of static balance or equilibrium; stagnation
Sentient	aware; conscious; able to perceive
archeology	the study of material evidence of past human life
denigrate	to slur someone's reputation
magnaminity	generosity; nobility
Gambol	to dance or skip around playfully
Myopic	lacking foresight; having a narrow view or long-range perspective
nexus	a means of connection; a center
coda	concluding part of a literary or musical composition; something that summarizes or concludes
quiescent	inactive, still
intractable	not easily managed
deride	to mock
petulant	rude; peevish
toady	flatterer, yes-man
aver	to affirm; declare to be true
Homogeneous	of a similar kind
Occlude	to stop up; prevent the passage of
blandishment	flattery
patois	jargon; a regional dialect
divulge	to make known something that is secret
Sycophant	a self-serving flatterer; yes-man
immutable	inchangeable
piquant	pleasantly pungent; attractive
Corroborate	to support with evidence
lethargic	inactive
Sacrosanct	extremely sacred; beyond criticism
antediluvian	prehistoric
oscillate	to move back and forth
fiat	arbitray order; authorization
Garner	to gather and store
conundrum	riddle; puzzle with no solution
sidereal	relating to the stars
platonic	spiritual; theoretical
compendium	brief, comprehensive summary
Castigate	to punish or criticize harshly
Zenith	the point of culmination; peak
Usury	the practice of lending money at exorbitant rates
esoteric	hard to understand; known only to a few
flag	to droop; grow weak
Supplant	to replace (another) by force; to take the place of
Indolent	habitually lazy or idle
allure	the power to entice by charm
dormant	inactive
timbre	voice tone color
complement	something that completes or makes up a whole
Impasse	blocked path; dilemma with no solution
Cogent	convincing and well-reasoned
Inchoate	no fully formed; disorganized
Zealot	someone passionately devoted to a cause
Frugality	tending to be thrifty or cheap
Venerable	respected because of age
poseur	poerson who affects an attitude to impress others
Eloquent	persuassive and moving, espcially in speech
Chicanery	deception by means of craft or guile
Zephyr	a gentle breeze; something airy or usubstantial
Seraphic	angelic; sweet
probity	honesty; high-mindness
pervasive	spread throughout every part
Fallow	dormant; unused
precarious	uncertain
Quixotic	overly idealistic; impractical
obsequy	funeral ceremony
atavism	in biology, the reappearance of a characteristic in an organism after several generations of absence; individual or a part that exhibits atavism; return of a trait after a period of absence
intangible	not material
Alacrity	speed or quickness
Nettle	to irritate
Pusillanimous	cowardly; without courage
abject	miserable; pitiful
arabesque	ornate design featuring intertwined curves; a ballet position in which one leg is extended in back while the other supports the weight of the body
Abjure	to reject; abandon formally
sensuous	relating to the senses
epistemology	branch of philosophy tha texamines the nature of knowledge
megalomania	delusions of power or importance
Lumber	to move slowly and awkwardly
vortex	whirpool, center of turbulence
harangue	long, pompous speech; tirade
herbivorous	an animal that feeds mainly on plants
cataclysm	a violent upheaval that causes great destruction and change
Peregrinate	to wander fro place to place; to travel; especially on foot
Declivity	downward slope
uncanny	myterious, strange
euphoria	feeling of extreme happiness
approbation	praise, approval
gainsay	to deny; dispute; oppose
exact	to force the payment of; demand and obtain by authority
Parry	to ward off or deflect, especially by a quickwitted answer
coagulate	thicken; congeal
refute	to contradict, disprove
problematic	posing a problem; doubtful
Verdant	green with vegtation; inexperienced
Gullible	easily deceived
recant	retract a statement of opinion
tirade	long, violent speech, verbal assault
Intransigent	uncompromising; refusing to be reconciled
irresolute	unsure of how to act; weak
centrifugal	moving away from a center
egoism	the tendency to see things in relation to oneself; self-centeredness
dearth	scarcity
preternatural	supernatural; beyond the normal use of nature
distend	to expand; swell out
attenuate	to weaken
talisman	charm to bring good luck and avert misfortune
literati	scholarly of learned persons
Epicure	person with refined taste in food and wine
exhort	to urge by strong appeals
tremulous	trembling, frugal, timid
Rustic	rural
extirpate	to root up; to destroy
Inure	to harden; accustom; become used to
qualm	sudden feeling of faintness or nausea
nugatory	trifling; invalid
Rarefy	to make thinner or sparser
Distaff	the female branch of a family
Ford	to cross a body of water by wading
contentious	quarrelsome; causing quarrels
implacable	inflexible; incable of being pleased or calmed down
Dissemble	to present a false appearance; to disguise one's real intentions or character
Explicit	clearly stated or shown; forthright in expression
Circumspect	cautious; aware of potential consequences
placid	calm
Affected	phony; artificial
taxonomy	science of classification
axiomatic	taken for granted; self-evident truth
tenet	belief, doctrine
propensity	inclination, tendency
onomatopeia	formation or use of words that imitate sounds of the actions they refer to
Hyperbole	purposeful exaggeration for effect
discordant	not in tune
syllogism	a form of deductive reasoning with a major premise, a minor premise, and a conclusion
malign	to speak evil of
machiavellian	crafty; double-dealing
Ostensible	apparent
visage	appearance, aspect
Doctrinaire	rigidly devoted to theories without regard for practicality; dogmatic
expatiate	to speak or write at length
flora	plants of a region or era
execrable	detertable; abhorrent
Knell	sound of a funeral bell; omen of death or failure
Mar	to damage or deface; spoil
sinecure	well-paying job that requieres little or no work
Arbitrate	to judge a dispute between two opposing parties
impervious	incapable of being affected; impossible to penetrate
fauna	animals of a period o region
riposte	retaliatory action or retort
emollient	soothing; mollifying
efficacy	effectiveness; efficiency
cant	insincere talk; language of a particular group
Pastiche	piece of literature or music imitating other works
Naive	lacking sophistication or experience
banal	commonplace; trite
Abase	to humble; disgrace
Ersatz	fake
resolution	determination, resolve
Spartan	highly self-disciplined; frugal; austere
Rejoinder	response
Umbrage	offense; resentment
Repast	meal or mealtime
disinterested	unpredujiced; objective
tenuous	weak, insubstantial
Precipitate	to throw violently or bring about abruplty; lacking deliberation
remonstrate	to object or protest
Credulous	too trusting; gullible
lucre	money or profits
Obstinate	stubborn; unyielding
tryst	agreement between lovest to meet, rendez-vous
causal	involving a cause
valedictory	pertaining to a farewell
redoubtable	formidable, arousing fear
Pugilism	boxing
plasticity	pliability; condition of being able to be shaped or formed
beneficent	kindly; doing good
Prattle	meaningless, foolish talk
Glower	to glare or stare angrily and intensely
Pithy	profound or substantial yet concise, succinct and to the point
Blight	to afflict; destroy
Legerdemain	trickery
Misanthrope	a person who dislikes others
Prudence	wisdom, caution, or restraint
misanthrope	one who hates humanity; one who dislikes others
Esoteric	known or understood only by a few
Heterogeneous	composed of unlike parts; different; diverse
soporific	sleep producing
vogue	prevailing fashion or practice
alleviate	to relieve; improve partially
Ostentation	excessive showiness
Vex	to annoy; irritate; puzzle; confuse
Ardor	intense and passionate feeling
whimsical	fanciful, unpredictable
fawning	seeking flavor by flattering
secrete	produce and release substance into organism
Sybarite	a person devoted to pleasure and luxury
torque	a turning or twisting force
mendacious	dishonest
fledging	beginner; novice
ambrosia	something delicious; the food of the gods
Cupidity	greed; strong desire
emaciated	thin and wasted
entomology	the scientific study of insects
demotic	pertaining to people
Potentate	a monarch or ruler with great power
Malediction	a curse; a wish of evil upon another
implicit	implied; understood but not stated
Proliferate	to increase in number quickly
sardonic	cynical, scornfully mocking
Quotidian	occurring daily; commonplace
extrapolation	the act of estimation by projecting known information
Inter	to bury
bacchanalian	pertaining to riotous or drunken festivity; pertaining to revelry
daunt	to discourage; intimidate; dishearten
Connoisseur	a person with expert knowledge or discriminating tastes
Leery	suspicious
insuperable	insurmountable; unconquerable
prattle	meaningless, foolish talk
vituperative	using or containing harsh, abusive censure
Craven	lacking courage
schematic	relating to or in the form of an outline or diagram
Surfeit	excessive amount
vindictive	vengeful, unforgiving
Idiosyncrasy	peculiarity of temperament; eccentricity
adjunct	something added, attached, or joined
Peccadillo	minor sin or offense
subpoena	notice ordering someone to appear in court
inveigh	to disapprove; protest vehemently
Sully	to tarnish; taint
Antagonize	to annoy or provoke to anger
eclectic	selecting from various sources
paragon	model of perfection or excellence
frugality	thrift
simian	apelike, relating to apes
apogee	the point in an orbit most distant from the body being orbited; the highest point
Erudite	learned; scholarly; bookish
interregnum	interval between reigns; gap in continuity
denizen	an inhabitant; a regular visitor
venal	mercenary, corruptible
Assuage	to make something unpleasant less severe
Parley	discussion, usually between enemies
codify	to systematize
Ebullient	exhilarated; full of enthusiam and high spirits
Catholic	universal broad and comprehensive
Monotony	no variaion; tedioulsly the same
Perfidious	willing to betray one's trust
euthanasia	mercy killing
perfunctory	superficial; performed really as a duty
Hapless	unfortunate; having bad luck
indigence	poverty
Precis	short summary of facts
inured	hardened; accustomed; used to
Chaos	great disorder or confused situation
officious	too helful; meddlesome
prehensile	capable of grasping
sordid	filthy, contemptible and corrupt
Requite	to return or repay
forswear	renounce; repudiate
Missive	a written note or letter
Impecunious	poor; having no money
minuscule	very small
Endemic	belinging to a particular area; inherent
Audacious	fearless and daring
tumid	swollen, distended
relegate	to consign to an inferior position
hermetic	tighly sealed; magical
Assail	to attack; assault
apropos	relevant
Amulet	ornament worn as a charm against evil spirits
Variegated	varied; marked with different colors
volatile	tending to vary frequently, fickle
Plethora	excess
inherent	firmly established by nature or habit
default	to fail to act
propriety	correct conduct, fitness
Collusion	collaboration; complicity; conspiracy
grouse	to complain
Hoary	very old; whitish or gray from age
virtuoso	someone with master skills, expert musician
Aesthetic	concerning the appreciation of beauty
Tangential	digressing; diverting
catalyst	something that causes change
florid	ruddy; reddish; flowery
Pariah	an outcast
Lampoon	to ridicule with satire
Jingoism	belligerent support of one's country
transient	temporary, fleeting
Anachronism	something out of place in time
tome	book, usually large and academic
plaintive	melancholy; mournful
converge	to approach; come together; tend to meet
impermeable	impossible to permeate
renege	to go back on one's word
appropriate	to take possession of for one's own use; confiscate
diverge	to vary; go in different directions from the same point
enunciate	to pronounce clearly
saturate	imbue througout, soak thoroughly
detraction	the act of taking away
brazen	bold; shameless
insensible	unconscious; unresponsive
salacious	lascivious, lustful
vertigo	dizziness
mnemonic	realated to memory; assisting memory
nostalgia	sentimental longing for a past time
centripetal	moving or directed toward a center
stolid	having or showing little emotion
Pathogenic	causing disease
Voluble	talkative; speaking easily; glib
substantiate	to support with proof or evidence
abate	to decrease; reduce
ambiguous	unclear or doubtful in meaning
Engender	to produce, cause, or bring about
innocuous	harmless
analgesic	medication that reduces or eliminates pain
disseminate	to spread; scatter; disperse
Abdicate	to give up a position, right, or power
turgid	swollen, pompous
Austere	severe or stern in appearance; undecorated
defame	to malign; harm someone's reputation
forestall	to prevent; delay
histrionic	relating to exaggerated emotional behavior calculated for effect; theatrical acts or performances
supposition	the act of assuming to be true or real
effervescence	state of high spirits or liveliness; process of bubling as gas escapes
tutelary	serving as a guardian or protector
Tome	book, usually large and academic
contend	to assert
metaphysics	a branch of philosophy tha tinvestigates the ultimate nature of reality
prodigal	wasteful; extravagant; lavish
Pervade	to be present throughout; to permeate
modicum	limited quantity
fissure	crevice
arduous	extremely difficult; laborious
Grovel	to humble oneself in a demeaning way
Volatile	easily aroused or changeable; lively or explosive
impute	to attribute the fault to; relate to a particular cause or source
ingenous	naive and trusting; lacking sophistication
belie	to contradict; misrepresent; give a false impression
Symbiosis	cooperation; mutual helpfulness
Insipid	lacking interest or flavor
buttress	to reinforce; support
continence	self-control; abstention from sexual activity
castigation	punishment; chastisement; criticism
harrowing	extremely distressing; terrifying
Panache	flamboyance or dash in style and action; verve
menagerie	a variety of animals kept together
deference	respect; regard for another's wish
cloister	to confine; seclude
porous	full of holes; permeable to liquids
Tawdry	gaudy, cheap,or showy
Hegemony	the domination of one state or group over its allies
thespian	an actor or actress
collage	artistic composition of materials pasted over a surface; an assemblage of diverse elements
Chauvinist	someone prejudiced in favor of a group to which he or she belongs
Dilate	to make larger; expand
desultory	random; disconnected; rambling
jocose	fond of joking; jocular
arrest	to stop; to seize
Lionize	to treat as a celebrity
Euphony	pleasant, harmonious sound
Posit	to assume as real or conceded; propose as an explanation
celestial	concerned with sky or heavens; sublime
Limpid	clear; transparent
diatribe	bitter verbal attack
necromancy	black magic
plumb	to examine deeply; determine the depth
defunct	no longer existing
Effrontery	impudent boldness; audacity
anodyne	something that calms or soothes pain
supplicant	one who asks humbly and earnestly
avarice	greed
nonplussed	bewildered
strident	loud, harsh, unpleasantly noisy
copious	abundant; plentiful
viscous	thick, syrupy
sodden	thoroughly soaked, saturated
congenial	similar in tastes and habits; friendly; suited to
empirical	derived from observation or experiment
contumacious	disobedient; rebellious
effete	depleted of vitality; overrefined; decadent
Mollify	to calm or make less severe
stigma	mark of disgrace or inferiority
Wizened	shriveled; withered; wrinkled
Venerate	to respect deeply
disparate	dissimilar
appellation	name
concomitant	existing concurrently
tangential	peripheral, irrelevant, digressing
Obsequious	overly submissive and eager to please
Mitigate	to soften; to lessen
oligarchy	form of government in which power belongs to only a few leaders
Prodigal	lavish; wasteful
erudite	learned; scholarly
truculence	aggressiveness, ferocity
alloy	a combination; a mixture of two or more metals
Xenophobia	a fear or hatred of foreigners or strangers
Deride	to speak of or treat with contempt; to mock
Pulchritude	beauty
Flag	to decline in vigor; strength; or interest
Lament	to express sorrow; to grieve
fatuous	foolishly self-satisfied
Gestation	growth process from conception to birth
caustic	burning; stinging; causing corrosion
vapid	tasteless, dull
Disabuse	to set right; free from error
Fractious	unruly; rebellious
Droll	amusing in a wry, subtle way
Salient	prominent; of notable significance
maverick	dissenter
elixir	a sustance believed to have the power to cure ills
extraneous	not essencial
trepidation	fear and anxiety
undulating	moving in waves
panegyric	elaborate praise; formal hymn of praise
Curmudgeon	cranky person, usually old
Fanatical	acting excessively enthusiastic; filled with extreme, unquestioned devotion
sundry	various
Obdurate	hardening in feeling; resistant to persuasion
Militate	to operate against; work against
Ingenuous	showing innocence or childlike simplicity
etiology	causes or origins
Profligate	corrupt; degenerate
Estimable	admirable
lambaste	to trash verbally or physically
imperturbable	not easily disturbed
Lugubrious	sorrowful; mournful; dismal
Enumerate	to count, list, or itemize
vivisection	dissection, surgery, or painful experiments performed on a living animal for the purpose of scientific research
levee	en embankment that prevents a river from overflowing
Diatribe	an abusive, condemnatory speech
garrulous	very talkative; wordy
bolster	to give a boost to; prop up; support
Liberal	tolerant or broad-minded; generous or lavish
Axiom	premise; postulate; self-evident truth
essay	to make an attempt; subject to a test
Jocular	playful; humorous
Diurnal	existing during the day
Vacillate	to physically sway or to be indecisive
phoenix	anything that is restored after suffering great destruction
Aggrandize	to increase in power, influence, and reputation
Ingratiate	to gain favor with another by deliberate effort; to seek to please somebody so as to gain an advantage
Contumacious	rebellious
Fetid	foul-smelling; putrid
flourish	en embellishment or ornamentation
saturnine	gloomy
Pallid	lacking color or liveliness
Eulogy	speech in praise of someone
impair	to damage; injure
chasten	to correct by punishment or reproof; to restrain or subdue
sedition	behaviour prompting rebellion
tout	to promote or praise energetically
Intrepid	fearless; resolutely courageous
Propitiate	to conciliate; to appease
gullible	easily deceived
abscond	to depart secretly
amenable	agreeable; cooperative; suited
Vestige	a trace; remnant
kudos	fame; glory; honor
Pedant	someone who shows off learning
internecine	deadly to both sides
cognizant	informed; conscious; aware
invective	verbal abuse
distrait	inattentive; preoccupied
Polemic	controversy; argument; verbal attack
peregrination	wandering from place to place
incursion	sudden invasion
Dupe	to deceive; a person who is easily deceived
clique	a small, exclusive group
boorish	rude; insensitive
somatic	relating to or affecting the body, corporeal
broach	to mention for the first time
Largess	generous giving (as of money) to others who may seem inferior
carping	to find fault; complain
terrestrial	earthly, commonplace
digression	act of straying from the main point
Pare	to trim off excess; reduce
Apathy	lack of interest or emotion
cardinal	of foremost importance
Languid	lacking energy; indifferent
fetter	to bind; confine
Deleterious	subtly or unexpectedly harmful
recondite	abstruse, profound
hirsute	covered with hair
Elysian	delightful; blissful
prate	to talk idly; chatter
vexation	irritation, annoyance
Impious	not devout in religion
Deference	respect; courtesy
ornithologist	scientist who studies birds
cosmology	study of the universe as a totality; theory of the origin and structure of the universe
specious	seeming to be logical and sound, but not really so
pellucid	transparent; easily understood
Wily	clever; deceptive
interpolate	to insert; change by adding new words or material
Foment	to arouse or incite
Whimsical	lightly acting in a fanciful or capricious manner; unpredictable
Coalesce	to grow together to form a single whole
latent	dormant; potential not apparent
artless	guileless; natural
credo	statement of belief or principle; creed
supersede	to relace, especially to displace as inferior or antiquated
vitiate	to impair the quality of, corrupt morally
Accretion	a growth in size; increase in amount
Polyglot	a speaker of many languages
ascetic	one who practices self-denial
gouge	to tear out; scoop out; overcharge
Dogma	a firmly held opinion, especially a religious belief
recalcitrant	resisting authority or control
odyssey	a long, adventurous voyage; a quest
Prescient	having foresight
rubric	protocol, title or heading
denouement	outcome; unraveling of the plot of a play or work of literature
cadge	to beg; sponge
shard	a piece of broken glass or pottery
juxtapose	place side by side
militate	to work against
expository	explanatory
convention	practice widely observed in a group; custom; accepted technique or device
explicate	to explain;interpret;clarify
Phlegmatic	calm and unemotional in temperament
stratified	arranged in layers
complacent	self-satisfied
dissonance	discord; lack of harmony
guileless	free of cunning or deceit; artless
viable	practicable, capable of developing
homogeneous	composed of identical parts; uniform in composition
covert	hidden; secret
Zeal	passion; excitement
simpatico	likable and easy to get along with
fulmination	angry speech
tantamount	equivalent
senescence	the state of being old
vice	a bad habit
debase	to lower the value of something
aleatory	due to luck
perquisite	a perk
remuneration	a salary
mordant	expressing harsh criticism
choleric	made angry easily
bilious	irritable, despondent
phlegmatic	calm in a difficult situation
touchstone	something that is used to make judgments about other things
auspicious	conducive to success; favourable
pundit	a spokesperson to the mass media
pyrrhic	victory with such a devastating cost that it is tantamount to defeat; 
enervated	exhausted